1111111111111111
100000P000000001
1000000000000001
10000000000E0001
100000000C000001
1111111111111111