1111111111111111111111111111
1E01000100010001000100010001
1001010101010101010101010101
1001010101010101010101010101
1001010101010101010101010101
1000010001C001000100010001P1
1111111111111111111111111111